  ***************************************************************************************************
          *   * * *         *     * *       * *   *       * * *     *   * * *   *   *       *       *
* ***** * * *** * * ******* *** *** ***** * * *** * *** *** * *** *** *** * *** *** ******* * * * * *
* * *   *     *   *     *     *       *   * *   *     * * * * *     * * *   *   *   *       * * * * *
* * * * * ******* * ***** * ***** * ******* * * * * *** * * * * *** * * * * *** * ***** ********* ***
* * * * * *     * *     * * * * * *   *   *   *   *   * *       *   *   * * *           *   * *     *
*** * *** ***** * *** ***** * * * * *** ***** *** *** * * *********** * * ***** * ******* * * * *** *
*       *     * * *     *   *     *           * *   * * *     *     * * *     * *         * *     * *
*** *** *** *** * *** * ********* * ********* * *** ********* * *** *** *** *** *********** *** *** *
* *   * * *   *     * * * * * *   *     *     * * * *     * *   * * *     *   * *       *         * *
* *** * * * ***** *** *** * * *** * *** *** *** * ***** *** *** * ***** ***** ******* * * * * * *** *
* * * * *     * *                 * * *   * * *   * *       * *     *               * * * * * * *   *
* * * * * *** * *** * * ******* *** * * ***** * *** * ******* * ******* * *** ********* *** ***** * *
*   * * *   * *     * *   *   * * * *       *     *   * *       * *   * *   *               *     * *
* ******* ******* *** * ***** *** * ***** ***** * *** * *** ***** *** * * * ***** *** *** ***** * ***
*           *     *   *   *     *     *     *   *   *         * * * *   * *   * * * *   * *     * * *
********* ******* *** * ******* * *********** * *** * ******* * * * * ******* * * * *** *** *** *** *
*   *       *     * * *   *         *     *   * *   *     *   *         * * * *     *   *     * *   *
* * *** *** *** * * * * * * * ******* *********** * ***** ***** ******* * * *** * * ******* ******* *
* * *     * *   * *   * * * *       *   *     * * *   * *   *         *     *   * *   *     *   * * *
* *** *** ***** *** *** ***** *** *** *** ***** * *** * *** * * * * ******* *** * ******* * * *** * *
* * *   * *   * * *   * * *   * *       *     *   * *   * *   * * * *   *   *   * *     * *   *     *
* * * *** *** *** * * *** * *** * *** * * ******* * * *** *** * ******* ***** * *** * * * ***** * ***
*   * * *         * *   *       * * * *         * * *         *         *   * * * * * *         *   *
* ***** * ******* *** *** ******* * *** ******* * * ***** *********** ***** *** * * * ********* *** *
*     * * *   *   * * *   * *   *   * *     *   * *   *     *   * *   *   * * * *   *   * *   * *   *
* ***** * *** * *** *** *** * * * * * ******* *** * * *** ***** * *** * *** * * * ***** * * *** * ***
*   * * * *       *     * *   *   * *       * *     * *   * *   *   * * *       * * *         * *   *
* *** * ***** ********* * ******* ***** * * *** *** *** *** *** *** * * *** * ***** * * *** ***** * *
*     *   *     *     *     *     *     * *     * *   * *   *   *       * * *       * * *   * *   * *
* * *** ******* ***** *** ******* *** ***** ***** *** *** * * * *** ***** ********* ********* *******
* * *           *       * * * * *       * *     * * *   * *   *   *       *       *       *     *   *
* * ********* * *** ******* * * * * * * * * *** * * *** *** *** * * ***** *** ***************** * ***
* *   * * *   *     *   * * * *   * * *   * *         * *     * *   *     *           * * *   *     *
* ***** * ***** * *** *** * * *** * * *** * * ***** * *** ***** * ******* * ***** *** * * * * * *** *
*   *     * * * * * *       *   * * * *   * * *   * *   * * * * * *       *   *     * *     * * *   *
* ******* * * * * * ***** *** ******* * * ***** *********** * *********** * * * ******* * *** ***** *
*             * *     *         * *   * *   *   *             * *   * *     * *       * *   *     * *
* *** ***** ********* *** ******* * ********* *********** * * * * *** * *** *** ******* * ***** *** *
* * * *   *             *     *   *       *       *     * * *     *   * * * *   * *   * * * *     * *
*** ***** * * *** *** * *** *** *** ******* * ***** *** * *** *** * *** * ***** * * *** *** * * *** *
*         * *   * *   * *       *   *       *   * * * *   * * *       *   *   * * * *   * *   *     *
********* ******* *** *** * ******* ***** ***** * * * ***** ******* * *** * ***** * *** * * * * *****
* *   *     *       *     * * *         * *       *   *   *     *   * *     *     *     * * * * *   *
* * *** *** ***** *** * ***** * ***** *** * *** ***** * *** ***** ******* *** * ******* * * *** * ***
* *   * * *   * * * * * *     *   *     * * *   *       * * *   *     *   * * *         *   * *   * *
* *** * * ***** * * *** ***** * *********** *** *** ***** * *** * * *** *** * ********* * *** * * * *
*   *   *   * * *     *     *       * *       * * * *   *         * * * *     *       * *   * * * * *
* ***** * *** * * *** * *********** * * ***** *** ***** *** ********* * * ***** *** ********* *** * *
* *   *       *     * *               *   *   * * *   *       *     *   * * *     *   * *   *       *
* * *** ***** * * ******* * * * ***** * *** * * * *** * *** ******* * * * * * ******* * * * * * * * *
*         *     *     *   * * * * *     *   *     * * *   *   *       *           * * * * *   * * * *
******* * *** * ********* ***** * * ***** ***** * * * * * ******* *** * *** *** *** *** * ***********
* *     * *   *         * * *   * * *     *   * *   *   *       * *   *   * *   *   *         *   * *
* * ***************** ***** * *** *** ***** * * * ***** * * ***** ******* * ***** *** *** ******* * *
* * * *           *   * *       *     *   * *   *     * * * * *   *       * * *     * * *       *   *
* * * *** ***** * *** * * *** *** * * * ******* *** * *** * * ********* ***** *** ***** * *** *** ***
* *     *     * *   *   * *   *   * *       *   * * * *   *           * *       *   *     * *   *   *
* * ***** * * ***** *** ***** *** * * ******* *** ******* * *** ******* * * * * *** *** *** * * *** *
*   *   * * *   *           * *   * * *   * * *         * *   *       *   * * *     *       * *     *
*** *** * ************* * *** ***** *** * * * * ***** *** * * ***** ***** ***** ***** *** * ***** ***
* *   * * *     *       * *   * * * * * *   *     * *   * * *     *   * *     *   *     * * *       *
* ***** *** * ***** * ***** * * * *** * *** * * * * ******* *** *** * * *** ***** * ******* * *** * *
* *     *   *   *   *     * *   *   *   * *   * * * *   *     * * * * *     *     *   * *   * * * * *
* *** * * ***** *** *** ******* * ******* * *** *** * ***** ***** ***** ***** * * ***** *** * * * ***
* * * * * *         * *   *   * *           * * *     *         * * *   *     * * *         * *   * *
* * * ******* ******* ***** * *** *** * *** * ******* * * ******* * *** * *** ******* * * * ***** * *
* * *                 *   * * * * *   * * *     * * *   *     *     *   *   *   *   * * * *   *   * *
* * * *********** ******* *** * *** ***** ***** * * *** *** * *** ***** *** ***** *** * ***** *** * *
*       *   * *           *     *     *                   * * *   *   * *   *   *     *   * * * *   *
* ******* *** *** *** * ***** ******* * ************* *** ***** * *** ***** * *** *** ***** * * *****
*   *           * *   * * *     * * * * *   *       *   * * *   *   *     *   * * * *   *     *   * *
* ******* * *** * *** *** * ***** * *** * * ***** ******* * *** * ***** ***** * *** ***** * *** *** *
*   *     * * *   * * *   * *         *   *   *   *             *   * * *   * * *   *   * *     *   *
******* *** * *** * * * *** ******* * *** * * *** *** *** * ********* * *** * * * * *** *********** *
*     *   *     * *   *   *     *   * * * * *       *   * *   *     *   *         * * * * * *       *
***** *** ********* * *** * ******* *** *** * * ********* ***** *** *** ***** * *** * * * * * * *** *
*         *   *   * *     *   * *   * *   * * * *     * *   * * *   *       * * *   * * * *   *   * *
***** *** * *** ***** ***** *** * *** *** ***** *** *** *** * * * ********* * * *** * * * * *** *****
* * * * *       *   *   * *   * * *       *       *     *   * * *       * *   * *   *     * * *   * *
* * *** *** ***** ***** * * * * * * * *** ***** ******* ***** * ******* * * * ******* ******* *** * *
*     * * * *   * * *   * * * *   * *   * *       * *   *   *   *   *   * * *         * *     *     *
* ***** * * *** * * * *** * * * * * *** * ***** *** * *** ***** *** ***** *** ********* * *** * *** *
*             *   *   *     * * *     * * * *     *       *       *   *     * *     *   * *     * * *
* ***** *** * * * *** * *** * ***** ******* *** *** ***** * ********* *** *** *** *** * * ******* * *
*   *     * * * * *     *   *   *       *   * *   *   *           *     * *   *     * *           * *
***** ******* * *** ********* ********* * * * ******* *********** *** *** * * * * ******* ***** *****
*   * * * *       * *     * *       *     * *     *   *     *       *   *   *   * *       * *     * *
*** * * * * * *** ***** *** *** ***** * *** * ******* * *** *** *** *** * ***** * * *** *** * * *** *
*       *   *   * * *   *     *   *   *   *       *   * * *   *   *       *   * * *   * *     *   * *
* ***** *** *** *** *** ***** * *** *** * ***** ********* * ******* * * *** ***** ***** * * ***** * *
*   *   *   *   *     *       * *     * * * * *   *   *             * *       *   *     * * *       *
***** * ******* * * ******* * * *** *** * * * *** *** * * ********* *** * ******* ***** * *** * * ***
* *   *   * *     *   *     * *     *   *   *   * *     * *         *   *   * *         * * * * *   *
* ***** *** ***** *** * *** * * *** ********* *** *** * * ******* ***** ***** * ***** ***** ******* *
*       * *   *     * * *   *   * * *         * * * * * *   *   *   * * * * *   * *   *         *   *
*** *** * *** * ***** ***** *** * *** *** *** * * * *********** * *** *** * * *** * * *** * ***** * *
*   *   * * *     *     *   *     *   *     *   *   * * * * *   *   *       *   *   * * * *       * *
* ***** * * ***** * * * *** * *** ***** ***** *** *** * * * *** *** * * * * ******* * * ***** ***** *
*   *     *       * * *   * * *           *     *             *     * * * *         *       *     * 
*************************************************************************************************** 
